1111111111111111111111111
1C10011C10000000000000001
1010011000000001C00000001
1000000000000001100000001
1000011000000000000C00001
10000110000000010000000E1
1P00000000000001000000001
1111111111111111111111111