1111111111111111111111111111
1C10011C10000000000C01010001
1010011000C00001C0000C010001
101000000010000110000000C001
1010011000C00011100000C00001
1010011001000100101000110E11
1P0000000C000100001000011001
1111111111111111111111111111